EEEEEE11EW4TTTE
WWWWWWW1WWWWWWW
1EEEEEE1EEEEET2
1EEEEEEEEEEEEEE
111EEEEEEEEEEE2
1EEEEEEEEEEEEEE
EEEEEEEEEEEEE2E
